combat_grace_period:25
combat_chance_per_tile:0.05
map:
###########################
#@      ########         ##
## ####    #     ## ## # ##
##      ## ##### ## #### ##
#### ##### ##  #      ## ##
#    #  #   ##   #### ## ##
#### # ##   #### ##      ##
####             ## # # ###
#########   ## ####       #
###########################
