combat_grace_period:20
combat_chance_per_tile:0.01
map:
###########################
#       ########         ##
## ####    #     ## ## # ##
##      ## ##### ## #### ##
#### ##### ##@ #      ## ##
#    #  #   ##   #### ## ##
#### # ##   #### ##      ##
####             ## # # ###
#########   ## ####       #
###########################
